2222222222222222222222222
2000000000000000000000002
2000000000000000000000002
2000000000111110000000002
2000001100000000011000002
2000000000000000000000002
2111100000000000000011111
2222211000000000001122222
2222222010000000102222222
2222222000000000002222222
2222222111111111112222222
2222222222222222222222222
