9999999999999999999999999
6000000000000000000000008
6000000000000000000000008
6000000000311120000000008
6000003200000000032000008
6000000000000000000000008
6111200000000000000031118
9999612000000000003189999
9999996040000000408999999
9999996000000000008999999
9999996111111111118999999
9999999999999999999999999
