0000000000000000000000000
0000000000000000000000000
0000000000000000000000000
0000000000111110000000000
0000001100000000011000000
0000000000000000000000000
0111100000001000000011110
0000011000000000001100000
0000000010000000100000000
0100000000000000000000010
0011000111111111110001100
0000000000000000000000000
